msq: pdm
cng: bms
szn: lrl mgk
clv: klk qrn
xkx: cvq hdx vhg
ldc: mvc jft pmf
glc: vsm jnf mhz tvd glf
qcr: xcv dfq
tcz: xzc rjf bjm pkk cft
rnm: qrc gxh
dvp: gqz nkd
qrv: zhr vgj
cld: bck btn
tkh: qbv hlh nkh xmv jdc
vqq: spl
lvg: zpk srs qtp rtf bmv
sgh: ghs vss sdl
fsv: crj hmj
kfd: brv jnd xrt rmz vgh
qsj: dkb txl hxn dxt
kjg: jff nsl gqr dcx
jcm: pvz
qgg: qnc jbr cdg
qhk: snz pqx cvp
mlb: rqb jpl
hdp: hgv tmv
blj: kdr jvl dvx hks
gmv: dlp pvz zzj
xbj: nvb
vmr: ndj bmv shq pgr
xtl: kqr njc
kvg: vsj xvf svp
ntv: vsm khx
lff: zfm gcr mrc
qnq: xhv
lxd: hqq spn
jlh: pqb hhd cng jkb
bzf: fxf tfv hks trg
tjv: hkh prm lgp qrv
rgj: pcz krk tfz rkj
xhn: cgd cld mps lvz bzs
xxt: rlh
cpm: kjt tbp mhc zsm ptt bnj
thk: psm ljk zml
rjj: nrp qrq ttz zmt
jkk: hpf bdf knk
bcx: khl khz
jxd: hzr mgk
rpv: xxc crc
gvl: phb psj
pkq: bdz bvm lkk vhk
krf: skc bzt dzl jcl
rvl: hqq zht qbv
gpl: rrt mjz qpb lrl gdd
mfn: tvf zkt phg xfh
hsc: rpl prm fbv
ksm: tzr zkl qnk zvk trx
gfd: mss
vdn: bqj zmt bmq zdl txl
xtg: jsz hgv
clq: vjq
jvj: zbl rpv
gmj: brs fhv rpd
mjc: hzq
xdf: dlt
gcv: xjs ptj znk
xtr: zvk bzk
vmx: fkh mdd lgt
qkr: spl pvp stx gqc pfg
xpp: zxq kdc kqj
lnx: xvc
npk: pvp jrv
qfd: tcs lkf mdj
plt: dpb
rcc: dsf kcb rct gxv
gxv: lvp fxf
dkf: fxt lgf
ddt: bfm brs cvv xxc
cvg: xxt zjz tht
hfb: vtv znk cqb
xbh: tgm fll
qrq: tmh
rgn: fxf fhv tkk
cbg: snz rrq jpl bxc
sbl: pzq fhv cft lxl
jcl: hhb lbp nzm
bsf: mpr qbd rdh
pgr: clz ggb
pdl: nmj qkp qzv fjf mrv
xnd: jzg bgf bcz
drm: xhm hch vfp phk
slq: lxj vxs dff dfl
scp: qdf cdf csn
dnx: vdz rpv gpp hvx
qpv: klc gfg bxc psj
cnr: chr xvd rbf
gkm: qbc xpp
dnf: tzp rhq xfh fgm vtx
gmr: gpk hvc rlh
qvz: plq tfz bgf
zml: rsn mvc
vgx: xkl qqs
kmk: kdr dtv qhj qpc
mhc: zjk ljx hcj
czs: kcv
dcm: zzj ftz
tmd: bxt gzd
ctf: pxv pff dpp hsx
djr: dpq ggb nlj srs
xkd: gtg
hmk: clz zcl
xsx: dzj vmx ffd htb
zmf: pqt hsc vjj
nqn: bnj tnj fqb rqb
pjn: kmc gpr hnj jvm gkm
xrl: hsx nfp hcq dhh
gvf: jcn dlt fbn
tpq: psm pdj
zhr: xrd
jxn: xsx hcr mpb crg
xpl: ddx jkb nvl
nmn: zfj tvf
vlj: qxb gnn
bbp: xhp lsb rcz vgj
mjz: qbt cld gmr
lds: lbp xqf
ckg: scf gqc bsf cxx dvs
fsb: tck mrj hzr tzr pxz
ddx: fvq
btl: xcm gkf kfc hdx qpg ghn ktr
cqm: qrr jxd mkg dcj cxd
bzp: bdd mgt vlk
pgg: fdc xbj
tzp: nzm tbx nhs tvd
qth: rrv tnj hzq
bhp: qsd tck knv
cmd: cvv
rrn: nnr dns
czd: rgk
bjm: xsv
bgf: rls
hjd: dxt
vbh: mhb kzv bcx fzh lhz
nzb: jcn gcr
dtk: nbb xqh vjj
dlt: lxr gfg
rsn: rxk rbk
tvh: mnv czg llt hsl vss
dbj: jmj pvb
jft: fpv
xgz: cxn frg hhd jpz
jnj: xdq rdh
bsk: rjk ccx znb rgk
ntc: snj
vmg: kng nnq pgf zcb
dns: hbn tfv gff
jms: rsn tzr
xpg: xdx dcj crg
svp: jsq cnt dbj
nvc: sqp pdv
jpb: rrq fjf
bck: bhl kvp
kdj: sns xhv ffx
bkl: qsl
hvj: qgh jdv gdx czd
kng: bck mnq dmp
sqd: blx shq nqt mkr
jkb: clq
krk: rnn ngb
jhj: ngm gpt pdv qcn
brv: fxv xph nhs
vgh: jtf
mqt: sms rnn qxr
dlm: bnp rks mhb
mbb: rpd gvf fgc
qvr: lgp ktk bxx
kgl: vvb lsj
hsx: fhn
hbf: cft
knv: cft
cbt: czs gzv kff
hcp: khz
vgj: jcr gbd
xng: jrr scj qjn pxz bvq rpd
jcr: xtj
ggb: nll
fgf: dzj
lmz: vsj hxl
lhg: gvv dzt vhk lpj rqx
hdt: qnq hqq
txb: jrf vpm
jbk: tfk qdf
qsk: jrv
tfp: hvc rqb
xqh: dpj
vcd: qbd
fnk: pfg ktz gvf rqx
lvz: gpp ktk hxj
znb: rdh
cxx: qzk jcr rpd
lzx: ktk srl qph lfm
dzj: mgk dpj
vzs: txl
zjq: rvc clq hxn
lkf: vsm
hrv: plk ssj vnl
rfn: pft
mqg: hhq zxc gzd
rnd: hvs tfp dph mfs pkt
dgk: clq msq fbt nvm
nqj: chr hhh
bcg: vpc hpd hxl rdf
bcd: psm
pgh: ckv
pct: xjx cqb pkh lfm pqq
dkg: hmj pbl
dph: trg
lfr: hhq rbf
nkf: rbk gmh
xdh: rbz mql pmr qtp xrt
rgp: xsn vpm spp khb
crj: bdv sdl
mqh: nsr
jnf: kgf qhh
bnc: mhb kmm rrt fqg
zfb: lhz fzj
rbz: kdc zhs qrc
shg: dzt dmj
lcc: cxd hdx
gbk: xrj tht
ssj: mll
mfh: dzj zjz
xgg: bdd rrv xsv trg nzs
cpb: nfp fqb rfc
fhg: rth fcx
mhp: qrq gzm phk rqq
dff: qqs lbj
gbq: mll
smm: jjq ntd hdc
fmd: dmg
nxp: njp thx stx
pbb: kjr nxp scj
rck: dmp stg khf lcl jvj
rlj: nhc qzk tgt vlv
skh: nbl ccv bsg kfl njc
tbf: znb srl
jfs: qlj mhz hgt jrt
gdx: lfq
pbs: hhq ndj mvp nsr
ghh: bjv pxt
snx: xcv jxx
fsj: vdf hnj jtf
fzh: vmz fpv
jvl: gbd xmf
jmj: nvl zxk
fzf: sdl qgl
mfz: mvc cxs dnk lgl
bnn: rrt zfb hvh
pjx: hxl kff zht
nzt: jxx gfg lhz
qbv: nql
sgb: ccv
slk: mdj jfs dvp mfn
qlk: vhg
bcf: cfr ljm nvm
ljk: ccx pmf dfq
hnc: srh jkb pcq vbs
nxj: bvm kcb
tpx: gkb pbz cvv mvc smm
dxr: vlk fcp
fvx: mzb ghl tph
dpq: jtf srh
zht: ccb pxr
hcv: xzh dlp fcx qll
psj: cfz
skn: rlp tvm
xkn: gpp vqq
bqj: vgh tln
kzz: qrc szd
qsd: vpd fgf grn
srj: lds qgg tcn ldf
jtf: lgf
kgg: chk
mzb: sqj kxm
rls: xvc
hjg: cvp hts mrj mfs
fzj: cpb xsv ffd
dsr: xqt kcv
pcq: xqf xzh zmx pdv
trx: bzs jqr zjz
flv: nxr bsb ghh
vqh: dsr nqt
ncd: hlh rmz dlp
jjh: qbv lfr csn
hmc: hdt
ngb: hvf fcx nxz
mdb: xkz srf ktz vtv
pvf: shq pvk
ktf: hlz szl vtx kzx
zdx: gbb sth xhx mgt rgn
fhx: rls
ghg: lms
rjc: bmx lxl
rdp: zdv cnt nhx
ghm: jhh spd lpr zfs
sfl: xhv pdm vzs jkb dqz nbv
lxb: cft vdz qtn
rkj: rzm qck kqj knk ldg
zjz: bmx gcl
ndv: hsx plj dmj cjs
tss: zdv kkr zmb
thx: sxn rjf
jls: ssj vfb lfh
ssh: xdf khf qmn
dhb: ppv tcs lxd bgz fvq
gkn: fxf ddj
rgg: cbl kqc jdc
vzc: zfs zmx kvr
zsk: sqj cng jsq ngb
tkp: gps lqs crf
xqk: kjr xkx xxt nnh shg
npl: gvh gzm tqs xkd
lgm: ndg cst rmz nsr kqc
vtd: tkk
qtp: rlv jbr
dcx: jnf bgx
rrt: nbb xdq
xmm: lxb gvm srg pvc
pkh: cvg mrv
rnf: rvd qzg jnn rgl mbc
zcb: hgx krt gnf
szd: pcz
fkz: jms gbh kvp xpg
kqr: rjq
pxz: mnm xmf qrg
zmt: mqd rzm
dqz: jpk jlr
fjv: dsf gng lvp
rzm: bgx gqz
nbj: ncx bsk jvl
xvh: nql lkf tvp
nlq: hdn sng zbh tgl
qtt: qhh qnq
xzc: ktr rcl tgt
dkk: jpl
cqq: cbs chl
cmt: ppv ptf hmk
xkb: zjq hqq zxl cdf
trr: hlh hbh zmb
dbt: jcm qxr tgl
ghn: zbl npk vcd
cbk: gbk kvq dmq
dhr: fcp pbj
scj: nzs
vbs: fmd pdm zkt zzr
ktd: tjh tzn lvz gxv gpp
vkr: lxm ttx hvx ccv qnk
rtk: khz mll kcl
ffj: hpf sfs xjz
rgz: zdf skn ttt njk ffj djv
jdt: fhx hns dkf dpb
jmd: zrm khx
mbm: ddx jnn kxm fvq
nbq: dvp xbh srs
qvm: pcz
tdn: dzl
nlj: ttz
bvq: gtb pmx
jsv: xhp dzt pmx lgl
sms: csc
cdt: pff dsf dkh zsn
tkk: lsb
qff: gkn sth lfc
hgh: slf bxc fzh pmf
ldf: nvc czg
dmq: hgk
tsc: rdp
hjv: rfb sng
rcz: vcb
tlz: xmv chl sns
nfb: vnl
dfm: phr zsm kfm thk
tck: pkh mxf
qmn: lbk
nrp: khx xvc jff
ccm: rmz tmd
jpq: bph lxr kdg jvc
zzq: rvv lbb nsl glt
nnh: zhh qsm
szz: xkl mvp
kfv: dvt xbj xgf mlf
zbv: jcb hvc htb
dzf: zxc
cft: znb
pdg: khx ttz bms
llt: bjf mzb
llq: chk khb tht
lmd: nlb sld rlc qlq
bph: pkm gvl
ttq: bgf xhm rlc skn
gpr: fxv tgm jcm
kzx: clm hhh
rln: dtg bcd pdj
qvl: zpc hjv bjf rnv
zcc: xhh rqb xsv
zjk: dkh szn
gpt: cdg kkv
zds: hxn clm gqz gmv
qph: njc jhv
pft: ttz
kln: pvb
kst: fsj msq xhv vqh
kvr: bdv qgl
zvf: bsb nsl hnj pgr
fhn: zhh kqr jfd qsm
tmh: jvm
kqj: lcr
vfb: bfm rxk zsn mnq
zvj: jpb jkz sdt ccc lgt
tnn: pbz ktk xxq kfn gbd
bbg: tvp nkd
kfm: ptt
zng: tkb nnh ncx
vzt: gxv kcl bcd
mss: rbf
gnn: khl qsm
jpz: tph rnv lms
dsx: fll qll npn nmn
tkl: rcz mbb jxg nnr
nhj: xzh gps jdh
kcv: cdg vjq
lxj: nxz pxr csc fhl
hmq: dbj jgh rvd
tbz: bqv jcl fkt fxp
stg: dzq jfd
jsm: hhq tmh lzh
thg: glc zgc lds nxz
tsm: tmv vqq xgf fxg
frg: gtg
qdf: tfz mkr pxt
mmt: dkg rmz hsl ccm
qfn: cpb tjk nsx lbk
hlz: bmq jgh sng
qvk: cvp mhv nmr
rct: dzj bxc nxj
zhs: pdm rvc
shz: zdv zxl
kjr: dhh hts
qgp: jmg rgl bbx
vxj: fbv
rbk: mgt
gbr: xxk
fqv: drg
bqn: znk qbz lsj jcr
bkg: zdv lzh pgr sjc
qlj: phg jvx
vdk: cxn dvb mkv
mlf: bzs chk
vtv: xgf
htl: fgm xph gzd
chc: gqc ccv vnl
rhf: pvk blx hvf bgm gtq
nsr: lbj
grn: dtg cfz gbh
rvd: gmb kdc
jkz: tbf ffd
qtc: xmf pgg fkg
dtv: kcb zhr
vmc: hzn ghg htl rhr tkp
vzh: pqr lgf lnx pbl
gbg: nzs lxm
sdm: mrf jbk qck jnz
xfh: crf jnz
hzm: bjd njc jcb gmh
gpk: kmh rjq
hlh: bzn
vnf: tvd jxk vbr plt rnv
zkv: kjn tsc ddk mqh fxp
tgl: dzl
jzm: xhm
mnj: lrl pgg krt jxx
mfg: fxk sns hgt pgh sbp
fxg: tpq dkh jvj
qbr: pvz vsj
cgj: nnp ghg
rhb: scf bjm
mhz: kss
mnq: vpm hcr fnb
ztl: gfd plq dcm
xjz: qqs
bjq: rzz vzs lqs mpf
vbp: vgj bkl fqv nnr
zkc: lfr gjd hmk bgz
qsm: xzq
jxx: czd
nmr: khb
ptd: qhk xjs fcp thx
xqr: sgs dcm hll zvc
kdf: pgk hxn ghh mgd
rvv: zdl kkv nkd
dln: bdf xpp tss bzn
xmp: hks tgr fdc zng
bzs: xzq
bpl: rjc qjv
zdf: fll ndj
jcb: dbv
zxc: csn
qrg: kmh hbn xqh
mxf: bpl cvp dpp pqx
hxq: jmj cnr
cxs: tjk
fmx: mpg ntc hhb dzl pjn
qht: vbs pmr fqn scp
nzc: lpv vhg gtb fgc
fdq: hmj
zkl: mhv mgt nzs
ljl: ljm qcn rkc
xmv: zxq
kbc: kdj hpd
gcm: shz tfk kkv kmc
pnd: vlj mjc xxk txb qsk bjn
bvn: pkh pkk kdt dmj
dvt: rgh hgk
pkp: xnd bmr mgd bbx
flp: nlr zhs
xtq: zpk jxk pqb
dpt: bcr qpv bkl hlb
jjq: jpl lxr dtp
lqs: qcn vlp jfq ppv
flj: ngm
gmh: qjv
kjn: dxs tvp
knj: btn hnt ntd
hhq: zlr
hsv: vzm rsj pdj
zmx: dpb vdf dkg
rgl: pxr
lbl: krt dxr bfm xhh
kgf: sgs vjq
jqn: jsz dtv jls xtr
hxl: kgf
gvv: ddt kfc
nxx: kzz mqh zfj kln
rpc: gxh kxm
zfs: vsm chr tsf
ntx: snj jzm
sbp: hsl xqt shj nbq jjn
hhd: lxd hcg
smb: gbq rtk
dnk: pxb kfm gbq
fqg: vlk vnt qlk
sns: pgk
kzg: nbj smb xcv gvs
ggc: krr xvf rlp lbp
dcg: gbg
mpf: rtf hjd ftz
mrf: lkf snj cfq
slf: drg
fdc: kgg qkp
jgx: zxk mvm nvm
mrj: kcl vvb
bdf: nch
dsf: klc
qqc: rgl cbs
xrr: vhz hdp vqq pkm
xhx: bcr
nnk: bjn khl bsg cmd
glr: gvv ccc kgl gbr
zsn: xsv
qrn: hjd
dpb: zcl
vbr: dnm qsj xqf
vdz: gdx
tsf: tbq nql
lcl: hvs lvp
bxx: dtg tjk
kkz: jll qpc
tvd: rlv
hpq: rlp ljl vgh vlr ljq
lxm: rbk
pmx: tfv
bkm: qrq nhj rhq cmt tgm
mpb: hdp kzv
pbp: qff lkk vjv qpc
dhh: qxb hnt
zsm: npk bsg
lln: jft psm lpv
rzz: xjz rfn tdn zhp
ncx: pbj
xvj: rsj cpb dzt ccc
hpd: fmd pth qgg
tnj: chk
jtk: ccx bzs jms knj
vfp: pmp jpv vpc
rjk: qcv psj qpg
pmp: pmr frg nvm shz
hvc: hhf snz
fkh: dmj
qcb: xqr djv vrx pcs
mvj: pqx qcv jcn vcb
tmk: zfm rjh dkk xtr
qbc: szl dvp hpf
qrs: fsj lvg pxt pvf
btp: qgl
lfl: vzc kdf rfn lgb
rpl: qzk
qlq: xkl mdp rbf
vgp: qzg fxt kkx
bjn: jsz
vkj: vns cmd qjn
pqc: jpk shz gxh dxs
kkx: gtg ljm qtt
jxg: kpk dmp
ldg: jlr
ssd: dbt qvz ttf zgc
vns: cxd khl
vpz: nnp
lks: fvk hqq bbg tdn
gvm: xcd gnf ggz pxb
zfj: lbb fjr
mhb: dkk
tfk: gfd btp
fbv: hks
rjh: qpc
mrc: jnj xtj
sql: prm bcd kpk bvq xdq
rlv: rth
tdg: fnb lgd nxj hzq
cqv: dxt
skc: fvq klk
phk: bdv mpf
szl: sms jcm
xkz: zhr mkg
czg: mql
zkg: xhp hdc mrv
htj: trr
kvq: vcd bkl hrv
jjr: fnm rhb nvb hzg pxb
zvx: xnh dvb jfq hmc
vpg: qxb vjv lvp zjk
nbb: gpp
sdt: dvm vmz xtj
qbs: szd mdj jcl hsl
gcq: mdd jfd pff
ttt: fvk
hsq: hjd rls
cdf: tbx
qjq: bgx hql
pqt: mjc qrv tck
vlp: lcr fhg jgh jmg
qlt: zvl mzd lmz vlr
tkb: rrq xkx
dch: hqz khf fkh zrn
pfc: cqq fzf rqq rpc
kph: hbf qrf lln plk lgp
hql: rth
jpk: qjs lcr
dst: bnj rjh
rdh: rrq
pkt: vdz lgd xxc
dmp: xsv
qpg: klc lxr
cbh: gzv dmg
bjd: gtb tjh
tcn: nbv rnm nhx
rfb: ngm xhv gzv
snz: cqb
bjf: xhr
kjt: hts vxj gng snx
cdq: hnb qxg qfm tqs
ndg: vdf nll
fgc: jcb
rdl: ddx hpf hgq plq fns
snq: mpb mjc brs vbd xcd
dvb: zzj
zbz: vdz bzk dxr
nhc: gcl phb fbn
fhk: tbq qqc ndg vjq
kfc: fnf zbv nvb
lgd: cgd zhh
htb: bbg dsf
kzd: vqh fdq flp nlr
kqc: dsr nqv
vbd: sth xxt
cnx: cxs pbb nvb gkb
bmr: csn cng
fsx: pff njc
fkg: xdx vvb fnm
kss: zvc dzf
drn: nqj zjq dvb xrt
gkf: dst pmf lgt qsk
cxt: sgs qrn dbj bgx
cnh: lbp lbj rtf pft
vck: jmd zlr ckf bzn
gps: vcc hmc tgz hsq vzs
hxp: hvf jdc pnt csn
kdr: lcl jft gmj
rhr: hfx gxm qjq dkf pgk
mhn: zsn vhz sgb rjc xhh
cdd: fvx kln msq jsm dnm
spd: tvm
kpk: hgk rfc
lhn: fhv dlt dzq sdt rpl
nlb: flp qgg
bhm: pkk fsx jhv zjk pff
clm: chr
qrf: dbv hhf dph
bss: phb fjv vzr dvz
bvm: brz
plq: ccm vls
gvs: cjs rpd gvf
dfl: crj pqc spn
mqd: pzh klk vpz
pgf: lcl jrr gbr kfl
vjj: spl dvx
tcs: ntv
cdh: ckv dbr vtf fsz gqr
xrt: xvc
shq: cnt
vbc: mkg lfm qlk zkx qth
cbl: mss tsc
fmq: hlf qkz czs
ljb: kbc tdf btp hhd clv bgf sxz
pvb: knk
xrj: szn bnj
fgm: mgd rth hbh
zjg: hsq
frc: hnb htj qrc bdv
dtm: jll ptd vns hcq
xps: fnb pdj lcc fgf nvb
gmb: xmv cnt qzg ccb
rdf: zpc tbq sns
mnv: pcq nvl mbc
jff: mpg fbz klk sqm
bcz: drn hxn
ntb: qzk snx xtl xcd
zbl: crg jms
pqb: tgm kzz txl fxk jtf hbh
zbh: kjk jbk lcr vzc zgc jfq
kmc: cdg
kmm: dns sgb mlf
bcs: zjg hdn vtf nch
scf: xcv
zdv: gxh
gxm: pjx nvc kcv
tvp: hmj
pfg: gmr nfp
hns: nvl prh
jxh: jxg
vss: csc djv
fxz: kmh pbb mfh dkk
scm: sqm qbv bcz vls
pvc: khf lpv dsk
lsv: fxv tsf rkc mfn
skz: fnb gcv hcj hzg cbk
krp: qbr tms tvf ckv
hcq: mdd bsg
qbz: dvm bhm rln
cxd: xmf
qqg: lgt xkn lvp
lsj: lsb
zzj: zmb vjq
pzh: xvd gtq qjq
kkq: lqt zhs
pcs: ztl hjv ccb kjn
brz: kfl cvq hdc
sqp: nql jmg
xjx: vdz stg nmr
hgv: cjx
gng: mpr xkx
cjx: hxj
ffd: rgk
sxn: ccx vjv gdx xxq
ljm: pcz
ghl: bzn
dkb: nkd
gnr: nqt pgh zxl spd
gbh: fpv
vkz: tpq bsg rjh
vlr: zxq lnx
fxf: xtj
bdv: pdg
thv: cbt nqf kbc vbs
fpj: hgx vcb xrj vnt
qvb: bzp
ssx: hcq rrn jkz tfp
zlk: pxd stx srf dvt
hzg: hcp
vtx: vtf cdf
hhb: clm mkr
nfp: cqb rbk
kcl: xbj
ghd: dpq hlf
jqr: dls qjv mlb fkg
fxt: nxr flj
bnj: fpv
xcm: mjc mgk jxh
nnq: cvq xxk kkz pxb rlh
gzm: ntv dcx bdf jzm shj
gnf: nhc mjb
qbt: ldd crc mkg
stx: bcx
plk: xtg
dmj: pbz
hft: nkf xdf jkt fqv lsj
jpv: klk xvd zxc rfn
krj: rks ptt rjq mlf
jfq: zvl
htx: xdx qrg fnb
pkr: pbj gpp pff lfq
qnk: hcp
vsc: kmh dzq khb tkg
pxv: rhb vkj tnj ccx
rfc: mrc
zvc: mss
qkz: hll zxc
mnm: gqc bdd
dlk: szz cgj vxs pjj xtq
srz: mpv lmz ttt srs
nqh: vtf xvh xhr
bhl: bmx jsz rgh
vpd: xkn tbf lkg dcg
zmk: fhg mdj klk nqj
hfx: hpf ntc btp
pxd: qcv
xqz: pvc bsf xxt pxd
fhl: ggb pvk
jfd: bzf
ggz: ktk
fvq: nqv
bjh: zxc nnp bmq
krr: pxt kxm
bpk: vpz fmq dcx nqh qgl
hcg: jzg drn qzg
qsv: vnl rcz hvs qzt
lfc: hgk qsl fhv
vrx: vgx jzg gkm
bgm: bgx pft jsq ldg
qhq: jlr gtq vpz hnb
dkr: hxq pth nvc
jdv: rrv mhk kgg qvb
kvp: bxx rrv
bnp: xpg nqp ptt
zhh: spl
xrf: krt zmf smb vhz
qjs: nlj
bzt: llt tgm srh cqv
nsx: vgj gcq xrd
fsz: jbr cqv qvm
qcd: qlj cdh bcf mgd plt
ftz: dkg
qbd: nbl
mkv: mmp dzf
jdh: lgf
vfr: tvf ttt cbl
jhh: nhx prh ghl
nzh: fjf chk ggz
qrc: pxr
gkd: lsb qmn lxm
kdc: bjf
bmv: sdl pmr nqv
hqs: crc fnb qsm
dlp: xvd
ppv: tbx
cnl: gbk hcr chk slt
dmg: sqm bms
bqv: fjr jnn
hcj: ncx gvl
hgx: vzt
cdg: rth
glf: rzz hlf hhh
sfq: rjk qsh fkg gkd
njp: hxj
lpj: dbv
pcc: rrn htj jfd nvb
jql: qnk jrv hkh pxd hmz srg
mll: hgv
zpk: fxk lbb nbq mvm
rfk: kkq fmd sfs tlz
lkg: qzt rjf
khh: gbh fsx gkb mjb
vhk: qrr hzg fzh
vzm: pmf mpr
pbj: fnf
fks: prh qbr jsq chl nqk
fqn: ghd frg vxs lqs
jbr: zpc
mhk: cfz
rhj: qph llq lkk dvm
zkx: drg bvq
bmq: jgx
trm: dhr prm vtv zvk
mpv: glt kkq vtx
mzd: bqj pfc fsv qrn
mjb: vcb slf
vzr: nzb qvb bmx mgt qsk
phg: rth ftz
qgh: dbv qrr
rxc: glc ttf cbh lms fhl
znv: jvm tfz knk szd fzf
jmg: txl
gqr: sqp zxk
tms: rnv qck xqr
cfr: hlf czg fbk
hhf: fbn bzk
lvd: vls jlr sfk mgd
qnv: nch szz jzm zzr snj
qxg: shq rqq crj
kvx: cpb mbx lxl pfg
gxf: plt bjv zht dqz
bqk: pvp jll xhx ktd qrr bjn
zns: zhh rpv bhp dsl knv
ddj: vbd rgh
zdq: bjm jxd gmh
trn: trg gbr tmk
snb: dtv qmn dmp lkk
clz: qrc
tjh: gcl
fbz: hnj dff
rks: jxh dxr
lgl: hvj nzb
njk: tmd qnc xbh
mdp: pgh fxv sqm
ljx: fjf
glj: dtp kdg gcr dcj zdq
nqp: bzs bdd jll
hxj: nvb lkk
gvh: vlp tcs
cjv: fbt xfh ghg qtt fns ntx
slt: hdp bpl bfm
fgp: gbr hnt qqg gnn
jzg: sgs rnm nvm ghd hdt
blx: sqp
tkg: cxl frj dtk lrl
kfn: hvh lgt
dxs: lds ldg zpc
rnt: cxs plj
rbp: plj qzt lpj llq
dht: bxt nsl mpg crf
phr: fnf
xhr: zrm
kjm: gfd rlv gzd
rqq: rnn
bgp: xsv nbb xzq vtd
cfq: pdv
zhp: nch nkh xrt
nll: gzv
dvm: hbn
pth: qjq qgp
hsj: zbz qff xhh lkk
lhk: nch tqs zvc gcm
qnc: lbb bzn
mpg: cfq
xhm: lfr
lzq: rvl vxs kzz ghs
vsj: gtg
dtp: kfl dpj
gth: nnr hdc pdj xqk
lgp: tzr
xph: rlc gmv
hbh: fdq
spp: hzr xcd fqv kgl
dkh: qnk
cxl: rxk nzt lhz rjk
fkt: jjn pcz qgg mfn hxq
nnr: vhg
nqt: mql
sth: mnm
std: xdf dpj bcr fsx
zgc: csc
gzd: lfr
qkl: dsl zkx hsv vkz
srf: slf jcn
rkc: crf spd
cnt: qgl
vlv: hqs dxr scf
dbr: cxn mvm htj jjh
sjc: prh hmq xpl
zrn: kzv jpb rpl zcc
fjr: qqs qnq
bbx: bms qcn
vxs: hmc pvf dbj
rgb: xtl gmh qcv lff jqr
pqr: nql tmh
xrg: cst vfr xrt tmh
nlt: zrm fjr frg rvc
jnd: spd qqc vgh
kcb: xrd
bxc: rcl
hqz: gcr lxl
lpv: jvc kfm
mdj: pgk
ntd: ssj gmr
ktz: cjx
qll: lbp cjv
trv: pkq nfb qtc ldd
jrf: bjd qcr dfq
spn: jvx zdl xkl
qxr: sqm
mps: qgh tpq
rzq: vns hkh bck nxp
bsb: lnx
hlb: rjc vtd frj
tgt: cft jrv
ttx: dst kfn jnj
srl: hdc dmq
kxb: xkz dmq gbg xhp lpj mhv kcl
ddh: jbk jnn xnz mmp
dgt: vdk snj sqj zjg
pds: sfs rlc rkc lbb
pkm: qkp zkx
nlr: cxn tph
nhx: lbb ffx jfm rdf
rfs: fcp bph bcx vcd
rbj: nbb dcj njp cvp
ztj: nnh pbb ttx tgr
qzt: cvq
mrv: xxk
fqb: hqs
hgq: hql fjr htj
tht: khb
fns: knk rpc
rhq: zcl hhh hns
qzv: cvv lfc
qfm: xjz jnz xkd
qjz: flv tsc bgx rgg
kdg: hvx znk xqh dvz vmz
npn: cbh hxl fhx
ccc: kfv
tsv: fhx flj shz dsr
kzv: kgl
vcc: srh kcv
rlc: tbx
qxb: qlk bvm fbv hcp
kvh: lcc tck mll pxd
kdl: hbf kgg ssh gfg fgc
zkt: fhl tph fxt skc
fxp: zfj vgx
ckf: jrt jfm nxz zxk
jkl: mqt ncd cqq xqf
zcl: fjr
xnz: dsr fhk gqr
gtb: spl ktr
nnp: lms
cjs: rjh fjf
kxm: lbp
nbv: dkb sgh jgh cbs zrm
vpm: ktz hbf
pqq: fgf htx gkn
dzq: nkf jvc gbg
zll: fxk czs xqt gpt
zzr: hjv nmn
ktr: hcr
zhd: gqz qvm mfg xgz
qzl: tfz dxt tdn zxq
dsk: brs xtg mhk xxq
tmv: phb rgh
cst: jkk vcc shj
vvb: ljx
lgj: brz vzm gpl rjf
mbx: dtp qrf jrr
pnt: xhr cng tdf jdh hdn
bvc: scj bzk hts ndv
gtq: nql
nxr: xkd
mlk: dph qxb frj chc
frj: vlk
mvp: sng jkk
vnt: dsf jxx jms
dtg: nmr
btn: cgd vtd
lfq: tht
lgt: fnm crc xrj
gff: hvs bdd qkp
ldd: rcl nzs
zmz: vls kmc zxz
fbt: rlp qvm
sld: sms nlq msq
bgz: znv nxr
hbn: gcl
dnm: fdq mmp
gjd: bjv mkv vpc
qjb: fqb crg dcg dxr
ljq: kvg mqg blx
lfh: bzf hvh cjx
hmz: trx pvp qcr
hzn: clm gvh bqv
jbd: bzn gmf tgl nlb rvc zpc
rtf: pvk mmp
gkg: njc tjh vjv hxj nzh
jjn: nch zmz dzf
pzq: dhh shg vpm fkh lcl
kql: krr dpq xnh qhh
gdd: hdx njp hzm
bpb: mgk zfb nbl vxj rnt
zjx: lxj hlf hvf hll
hkh: vtv jrr
sfk: vcc kqc
chl: hnb
qsl: mps pmx dtp
xnh: qqs
kkr: nvc zfj
djv: jvm
qhj: fkg jpl xzq dvz kdt
mbc: ckv srh
tgr: mrc bcd
dxt: ffx lzh
jrl: ngm sfs jmd tdf zdl
tln: bmr sdl zmb
ttf: pvb hvf rnv qxr
qhl: xhx gbd tzn bnn
mnr: cjs xkx kpk tgt
rkz: zxk zlr zjg vgp dgt cnr
jxk: qfd mqh
jkt: dvz xgf
nmj: ljx crg thk
hch: lms qvm
plj: tkk
hcf: nbl hvh rnt vlj plk
xkl: nzm
fvk: zvl bgm
kff: pdv hvf
slp: ppv ntc djv mhz
bxt: jmj kqj pbl
zrz: mfh gkb jms txb
kjk: vsj ldf flj
qgk: nll kkr bsb fcx kss
xvf: clv nhs pbl
hvx: drg
zjc: fnm cmd rxk trn
mdv: qbc vck xqt sfk
gmf: zdl
qtn: hqz jvc pbz rrt
zqn: fxv lbj mfg tms
rxx: rrt vpm rjq gpk
sxz: hch sqj krk
xsn: hfb mpr tfv nfp
vtf: kzx kkv
hsd: mfs vhz pdj kkz
dvs: znk xxq lfm
nkh: pvz lbp
qck: qhh xmv
dpp: rgk nfb
jnz: hdn jrt
rqx: klc dhr jsz
vhz: ddj rfc
jhv: dkk jxh
chs: vdf xnh jfs ntx
rsj: crg cfz
glt: lcr fbt
ccb: hll
jrt: sqj
jlr: rnn
dmx: gkn lpv vxj nzt
mmp: ffx cfq
znn: mhk lkg qvb jkt
jpl: rcl
lbk: dfq xdx
nhs: zmx
qjn: nfb kgl
lbb: zlr
fbk: jdh nzm zzj
lfm: knv pgg
bjv: vdf
lrx: ncx ccv pmf fqg
xzh: bjh vpc
jvx: tdf hql
rqb: zfm
hgt: shj tvm clq
ptf: vtf nqv dkr
zxz: qjs sms zxl rlp
bdz: mlb phr
zlj: qzk ljx qpb sxn
hqq: ghl tqs dkb
qpb: pkk
dvx: lfq ggz
ddk: fsv cqv bjf
tbp: ssx fbn ttx
pts: gqc rlh qvr czd dlm gbq mdd zkg
mfs: cgd
ghs: zrm
jjj: tjk zsn mhv qzv
lpr: lzh gnr gmv
tgz: qfd zdf qjs prh
gbb: zfm phr ktz
tzn: xrj kcb
qsh: xdq lxl hnt
kdt: sth vnl
pqx: dzt
ktt: hgx htb sgb qsm
ptj: ldc tgt bdz
pjj: lbk jcb fnf xkn
rpd: bcr
dsl: dsk qvk
rzb: tvm ghs kln cst
lgb: nlj kvr cgj fbz
jgf: khz zml tkb mvj xrd
ndj: cfq
nqf: cbs rjj gmf
mql: zvl
jfm: frg pbl
jdc: kjm fll
xxc: ldd
lqt: mkr pqr qkz mvm
bms: ttz
xjs: dcg zvk
nqk: clz gmf tbq
tdc: qpb lxr zhh lrl
dls: zjz qbd qjv hzq
vmz: kqr
srg: bph hzr
