yoy: dtu sgc qjc viq
vyp: tcu wrp
xof: jlp puv cth jwv
bvz: pis
mec: nem rak
bxi: ykt rie
ztr: xhp gms
mbs: isu bez pna
yzt: fqw ubj rhi
ctd: fri lpm run
bkj: hqz kag chj mop ysj
cml: wsd qdv wjf moy
jjv: pgt rua you
hwk: uvn
xvk: tre
jjf: kag hqz chj mop ysj
goe: kas
xuc: zdt
fqw: qrh lyw umm bjp
run: hjt heb jyg
yuu: vqz jih
jya: uuv kgc ero onh
bid: rcu aap zag
sll: evf uuv ero
fri: hjt
jzu: wyu wrp tcu
lsv: amz bzc els
nkk: upz nos
zvf: phf cpk sez edr
lcc: isj pgs
kmm: ave zou plb
cpk: eud pix wqm
vow: mcl vfd
ofc: typ
gtb: nmi yfy syh
ejd: azc qqp uxi zej
jxr: zwh oec nwz vch
tgx: wrp tcu
pmo: els bzc amz
hyd: wvv xeq
xcr: rvg dpn
wrp: weh yzt foo dcq uob
lbj: wyu ygr tcu
egw: cga
xnf: xeq bar kmm wvv dea
moy: pxf fvd
nsu: lcc kpp ftz
dcq: rcs vtd fal
uyh: out
opo: isi
cyu: cav zzc cao anq eze wlg jcn xpr gof syk dko cml cfq fmg xdi ytv egw vwg bsm cdi fki bmv fuf nlr clr
tom: yec uxi zej
vxo: ykk auv lry kmd
fjd: vxo obq
xhb: xro qzn
djq: ysj kag hqz chj
pve: out
zvx: byt fjg
heb: djq
ejy: pis urk cfx opo rdh
rib: mtt fjo tas pqh
tgh: mdu cbx hfh
cjv: iow vre
fmg: bey
mlf: kis
sgc: rib
awe: afr
edr: jzd wqm nrn
bqo: cpc ico twl
rld: jir
ave: cpc ico
tzw: hmh
sqt: cxy wrp wyu
wub: oec
qtm: ihy uwg oyu
hsp: cxy
obr: dst nre fft
inc: tve
amz: out
uwr: edu oun pjg
htk: ysj chj
zwe: tgx ccu jzx vyp
agc: npi hwk gnl
uvz: xdr mbs
yfy: ylw zyq lcx
zou: ico
nos: upw oim
syk: zvf att ckc
xow: uyh yel
uce: cxy ygr wrp
cbx: esf afr pgx
vam: vsa wnl
gmj: xex fdp ghk
lgs: tcu cxy wyu
gxv: ggt axc
hnh: esf afr
lgj: you
nma: oqs yel uyh
jcn: bey yht qtm
kwd: els bzc
fjo: kqy qdy mwi
cga: zpi eyb hnh
quf: bar dea
coh: wcq feg rak
fbh: rmn fvk xyx dxv
pgs: zag rcu
flr: wil
dpn: ysj
nri: lnk
vsl: pgt you
mqp: lnk gsk vvf
rie: yhv
yzn: ccu jzx tgx
jsm: nwz vch
and: cjv wil
ihz: vrb xuc ael nkk
zej: feg rak nem uso
hfh: afr
ckx: pdl
kjz: out
qdp: xdr zka mbs
ihy: ogt tgh
usc: jwf npx vee yhe
zpc: afr esf
gtm: qrh lyw wzo umm bjp
cwp: qii paz lkx
qsp: vyw dve nvi tud
itw: cxy tcu
dkm: out
vbr: evf uuv kgc
qzn: out
kna: tgx jzx
rgi: jlp vrw cth
nrn: zpc
xpr: ovd kar
plf: mop chj kag
kgc: uce hsp
olx: jjf gyn
van: rgi xof psj
tlv: lou kas gri kwn
wjg: rua pgt
azc: wcq
qme: you
yma: hzs vjr
zuw: out
wjh: afr
cjh: lou kwn kas
wxs: kmd ykk lry
syh: ylw
mlk: pgx
rhf: fal
thd: chj hqz mop
iow: kag chj mop ysj
sro: hxf inc lvz
ckc: edr
yel: out
dmx: run fri crk
zew: you rua pgt
jrv: feg wcq nem
vle: kag ysj mop
ptd: hbp
xex: qfi
ioj: pgt you
zfq: sof rld
lyw: uso rak nem feg
fpp: xof psj
eex: cxy tcu wrp ygr wyu
rip: rld hih pcq rmv
ren: out
fhk: yoy fvk rmn
wcq: sjo rwb hjo rvu miq mlf cqk hdl flr ykr xpc and fgm
pfs: plf rvg
vfd: afr pgx
byt: rho
pts: out
rto: wjg kjt vsl ioj gjs
tre: you rua
rho: qme feo
gre: jzx
wsw: wrp wyu cxy
qpg: usc
pjj: cvk
dve: ynq qwc
anq: rqt crs
pxf: pgx
ldp: ogt
hzs: kag chj mop
mnj: irl tfm
ygr: hln rfw rhf guu nfp weh iwg vfy dkg uob ooh yzt aas bxi dcq sro rsa dio zhl fjd
miq: vyw tud
kas: xev
elv: nem feg wcq
asn: oid rho igi
ykt: yhv ejd rjm
qcv: plf
viy: nem rak wcq feg
zny: hwd wsw
xev: pgt you
ovd: zpi klm eyb hnh
ygy: feg
bix: zvi sfd jrg
xod: rip eda nob
ikg: hmh
uzc: pgx
fpf: feg
ytv: hem axc ckx
fft: sqt akb
ksj: vle
gms: yfy nmi
nob: pcq hih
vch: awe orp uzc
zag: gcc gob yfg
sbe: oim xhb upw
lqu: kwn ile kas
svr: vpo cyu hfy csx
mja: ucz ren
vvf: rcq alw zny cit
chi: rak nem uso feg
sle: dbw
pqh: xrz kqy
fna: tjd
eze: kar ovd cga
bbh: evf onh uuv
bjp: feg wcq uso rak
lcp: edf foa
wjf: pxf
ooh: hxf xey lvz
eda: sof rld rmv
pnn: pgt
isi: ghq rmb bes bco
hjt: vle
ucz: out
urk: isi jju
pjd: hcq bfj wmj
gxj: crk
igi: rsh feo lgj
puv: zwe kna yzn fck gre
zcc: prr sfd
pjg: kwd pmo ltz
xsy: mja tfm irl
oqs: out
nkn: dst nre
vpg: pix
lcx: nma xow ptd
cfx: isi jju aiv
fvd: pgx afr
qin: mja
rxm: lcc kpp ftz
vrb: nos miw upz sbe
xhp: nmi syh
lou: jjv
skj: xex fdp uwr
irl: cop urg
tgv: ysj mop chj hqz
yef: lpm crk fri
bmv: ubd wsd wjf
dko: rqt
hem: wub uws
vpo: nlr clr fmg cfq jcn cdi gof fki fuf cao anq xdi egw ytv vwg bsm cav zzc
hxf: lkf tzw ikg
jir: chj kag
dzm: kpr usc
kag: lqu kia gjg cjh qpg oco tlv flp goe upr nsu yah
cop: out
qmi: tcu ygr wyu
wil: vre iow jjf gyn
ero: zpz qmi hsp uce
nxp: nkk ael xuc vrb
feo: pgt rua
qdy: out
iiz: uso
kpp: pgs bid ofc dac isj
bco: dkm
hmh: feg nem uso
wzo: feg wcq
rcq: hwd
upw: lav pro gbk xro
rmv: jir bkj
zhl: xey lvz hxf
zvi: bbh ebn vbr sll
ysj: sfl yah tig nsu wfi flp goe gdj cck cgn tlv kia upr rxm oco ccr qpg lqu cjh
wvv: bqo ave
cck: kpp ftz
yht: ihy uwg ldp oyu
uob: hxf inc lvz xey
gdj: okn
rjm: zej qqp yec
lqn: ysj
rrm: qii
tfm: urg ucz ren cop
jlp: kna zwe
xxa: esf
jju: ghq bes oev
ikc: xyx rmn
ogt: xmm hfh
gwl: gmj wwm skj
kia: byt fjg
hjo: yef ctd dmx
vtd: jrv mec qxg chi ygy
wyu: hln ooh rhf pjd rsa iwg sro zhl fjd
viq: zdz srl
xdi: lcp crs
vre: chj
npx: gjs vsl
hbq: jxr wub uws pdl
vyw: ynq qwc nff ujo
psm: vvf gsk
csx: egw zzc vwg cml nlr clr cfq gxv fmg xpr jcn fuf syk bmv
pis: isi jju
upr: gbi
qrh: wcq feg nem uso
ico: itw eex jzu vsh
mcl: afr pgx
inm: eps tre zew
cxy: dio rsa sro yzt ooh dcq bxi aas iwg weh uob dkg vfy hln rfw rhf foo
xro: out
evf: zpz qmi hsp
aaa: dbw nxp
pna: lkx paz
pbb: mcl wjh fwp vfd
eij: wrp ygr tcu cxy
wdl: wil cjv
clr: ggt
cdi: ckc zvf
yjj: jih
vrw: fck yzn zwe kna
hqt: pgt you
eps: you rua pgt
oec: orp
vqz: wcq feg rak nem uso
you: uyu fbh cll ztr ikc fna fhk tee squ sqf hnr
zyq: loy nma xow
rak: cbr hdl miq mlf hjo xpc ykr yur rvu flr qsp
rcu: bjw gcc
zka: cwp bez rrm isu
ibw: ysj
rvu: mbs xdr
dea: bqp bqo zou plb
hfy: cfq fmg clr cml bmv cdi gof xpr eze cao vwg zzc egw ytv
zoj: xsy
nfp: irw ykt
ykk: elv iiz cim
qex: vsa nkn obr
eru: mop kag hqz
rua: hnr sle sqf squ atn fhk aaa zpd ikc kiy sgl eca fbh cne ivi cll uyu agc
uso: hjo rwb qdp qsp pih lzq and fgm mlf
wnl: dst nre fft
cqk: yef gxj dmx
yzh: urk opo
pgx: dpa van zcc quf vam goo vxk pjj fpp
vfy: ubj fqw
jzd: chk zpc
wlg: moy wjf ubd wsd
sgl: xhp
rfw: bfj wmj
fck: vyp tgx
nlr: lcp crs
mdu: pgx
plb: twl ico cpc
goo: psj rgi
wfi: okn
upq: skj
upz: upw
gcc: pgt
kar: zpi eyb klm
cao: qtm
crs: foa edf pbb vow
nvi: kib nff qwc ujo
ubj: bjp wzo lyw
isu: lkx
lnk: rcq zny cit
hnr: xhp gtb
atw: cwp bez rrm pna
uws: zwh ewg oec nwz
mga: coh rth
tcu: guu nfp rhf uob zhl bxi fjd
ynq: sap pfs qcv
kpr: rto npx jwf yhe vee
hcq: vqz fmn
kpi: rip
yhv: uxi zej
gjg: byt
fal: jrv qxg chi mec
chk: esf afr pgx
tjd: zoj uhp
sul: pnn rsh
ylw: fhg ptd nma
bqp: twl
rmn: viq
gkv: ygr
hqz: kia gjg oco dzm ccr rxm sfl yah
vwg: bey yht qtm
bfj: fmn vqz
cne: xyx yoy
axc: pdl uws jsm
eyb: esf afr
fhg: yel
jbw: qqp yec
uxi: feg uso nem rak
tee: yzh ejy
nff: xcr
edu: ltz kwd
sfd: vbr
hwd: cxy tcu wrp ygr
yhe: kjt
kwn: xev hqt
qfi: lsv
fjg: oid
mop: tlv qpg cck cjh kia zvx tig rxm
ftz: bid pgs isj
klm: afr
irw: tom jbw
vsh: wrp cxy tcu
sqf: skj wwm gmj
cth: yzn fck gre
esf: dpa hyd zcc ozc amq goo nri pjj xnf vxk
bzv: pgx esf
nem: wdl mlf cbr uvz pih bsg rwb xpc ykr
qwc: xcr nit qcv pfs
zdt: upw oim
hbp: out
jyg: htk djq vle
bes: pve
pgt: tee atn gwl zpd ark fna uyu kiy ikc upq ztr
clb: pgx esf
bzc: out
uvn: ycj qin
ycj: mja tfm
bez: paz yma
xdr: isu pna rrm
uuv: hsp qmi
xmm: afr
cpc: gkv jzu vsh eex itw
dxv: dtu sgc
squ: gms xhp
zzc: att ckc
dio: vtd rcs
fki: moy qdv wjf ubd wsd
zpd: bvz
nre: eij
flp: fjg asn
aap: yfg
cbr: olx
rwb: dmx yef
yah: elo
fmn: wcq feg
elo: isj dac ofc bid pgs
guu: rcs fal vtd
edf: mlk
oco: xvk lib
cit: lbj lgs
crk: jyg eec
kjt: you pgt
qys: mnj
obq: auv
pix: bzv
sap: plf dpn rvg thd
cav: kar ovd
ryc: clb mdu xmm hfh
cgn: kwo inm lib
vjr: chj hqz kag mop
npi: qys uvn
isj: rcu aap zag
sez: eud jzd wqm
dst: sqt
hih: ibw
iwg: gtm fqw rhi
kqy: out
lry: elv viy iiz cim
eec: htk
gob: pgt rua
lib: zew eps tre
lkx: vjr lqn
ile: jjv
rmb: kjz pts
fgm: zka mbs
eud: bzv zpc
zwh: uzc
kmd: cim elv iiz viy
kiy: yzh bvz
fuf: att frp
uwg: ogt ryc
dee: esf afr
mtt: xrz kqy
onh: hsp qmi zpz
gbi: igi sul oid
dtu: srl
oun: lsv pmo
ghk: edu oun
gyn: mop hqz kag chj
ark: hwk gnl
kwo: tre
cim: uso rak feg wcq
tig: usc kpr okn
uyu: npi hwk tjd gnl
nnp: psj rgi xof
oim: pro gbk lav
rhi: lyw qrh umm
srl: tas fjo mtt pqh
zpi: pgx
twl: gkv vsh eex itw
xpc: tud
bjw: you pgt
nmi: lcx
att: vpg cpk phf
yec: feg wcq uso rak
psj: cth
rqt: edf
xrz: out
cvk: jya
pwl: mwi
pih: nvi dve vyw
cll: ejy yzh
tve: hmh coh rth
rsh: pgt you
xeq: ave bqo
qjc: srl rib
tud: ujo kib nff
eca: ihz
jrg: bbh
pdl: zwh ewg
sjo: zka atw
vee: kjt wjg ioj vsl gjs
lpm: ksj hjt eec heb
dpa: jrg
okn: vee yhe jwf
aas: fal rcs
sof: eru
lzq: xod
rdh: aiv
bsm: yht
nyq: hwd wsw lgs
wqm: chk zpc bzv
frp: sez cpk edr phf
prr: ebn bbh sll vbr
nwz: wlw
amq: nkn obr
ujo: sap qcv nit xcr
dac: aap typ zag
lav: out
ebn: onh ero kgc evf
atn: gms xhp
hdl: tud nvi dve vyw
jwv: gre
edl: kis xod zhz kpi
jzx: cxy tcu wrp ygr wyu
oev: zuw
ael: sbe upz nos miw
loy: hbp yel oqs uyh
qxg: wcq
nit: thd
ltz: amz els
gbk: out
cfq: ovd cga
fdp: pjg
ozc: jrg sfd cvk
gjs: pgt you
bey: uwg ldp oyu ihy
els: out
gof: hbq ckx axc ggt
qii: lqn hzs vjr tgv
weh: hcq yuu yjj bfj
qdv: fvd pxf xxa
aiv: rmb oev bes
chj: tlv cgn cck gdj gjg kia yah wfi tig nsu sfl goe flp ccr qpg dzm oco cjh lqu zvx upr rxm
gsk: zny nyq
rsa: lvz
ggt: jxr jsm
ubd: pxf fvd
vsa: fft
fvk: qjc
mwi: out
oid: rsh lgj feo
vxk: xof
wwm: fdp uwr
miw: oim xhb
foa: fwp wjh mcl
orp: esf afr pgx
zpz: ygr wrp cxy
dkg: rie
pll: zew
uhp: qin ycj mnj
kgp: ykk auv lry
fwp: esf pgx afr
jwf: vsl
tas: qdy kqy
sfl: kwo pll
zdz: pwl tas mtt
wsd: xxa pxf fvd
urg: out
wlw: pgx afr
lkf: coh hmh
kib: nit pfs sap
rth: uso feg wcq
rcs: jrv qxg chi mec
paz: tgv lqn hzs
feg: hdl mlf cqk wdl rvu hjo qdp rwb sjo and fgm cbr lzq ykr xpc edl flr uvz
hln: kgp vxo wxs
bar: plb
afr: dpa nnp mqp quf vxk pjj psm vam hyd bix zcc qex xnf nri
ivi: wwm
pro: out
alw: lgs hwd lbj wsw
dbw: nkk ael xuc
pcq: ibw eru jir
yur: cjv wil
gnl: zoj uvn uhp
qqp: feg wcq rak nem
akb: ygr wyu cxy
umm: feg
lvz: ikg tzw lkf
zhz: rip zfq
rvg: hqz kag ysj mop
yfg: pgt rua you
ghq: pts zuw dkm pve
ccr: lou kwn gri kas
xey: mga lkf tve
xyx: qjc dtu
kis: eda
bsg: zhz
wmj: jih
ccu: tcu wyu
oyu: tgh ryc
foo: wxs
ewg: dee uzc wlw
gri: jjv hqt
phf: eud nrn wqm pix
jih: uso nem
typ: gob yfg
ykr: dmx ctd gxj
auv: cim fpf elv viy
